createLinearGradient()	Creates a linear gradient (to use on canvas content)
createPattern()	Repeats a specified element in the specified direction
createRadialGradient()	Creates a radial/circular gradient (to use on canvas content)
addColorStop()
rect()	Creates a rectangle
fillRect()	Draws a "filled" rectangle
strokeRect()	Draws a rectangle (no fill)
clearRect()
fill()	Fills the current drawing (path)
stroke()	Actually draws the path you have defined
beginPath()	Begins a path, or resets the current path
moveTo()	Moves the path to the specified point in the canvas, without creating a line
closePath()	Creates a path from the current point back to the starting point
lineTo()	Adds a new point and creates a line to that point from the last specified point in the canvas
clip()	Clips a region of any shape and size from the original canvas
quadraticCurveTo()	Creates a quadratic Bézier curve
bezierCurveTo()	Creates a cubic Bézier curve
arc()	Creates an arc/curve (used to create circles, or parts of circles)
arcTo()	Creates an arc/curve between two tangents
isPointInPath()
scale()	Scales the current drawing bigger or smaller
rotate()	Rotates the current drawing
translate()	Remaps the (0,0) position on the canvas
transform()	Replaces the current transformation matrix for the drawing
setTransform()
fillText()	Draws "filled" text on the canvas
strokeText()	Draws text on the canvas (no fill)
measureText()
drawImage()
createImageData()	Creates a new, blank ImageData object
getImageData()	Returns an ImageData object that copies the pixel data for the specified rectangle on a canvas
putImageData()
save()	Saves the state of the current context
restore()	Returns previously saved path state and attributes
createEvent()	 
getContext()	 
toDataURL()
